how old is lil moco	NUM
apartment cost in phoenix az	NUM
how far is niagara on the lake to hamilton	NUM
how big is a micron	NUM
who owns charlotte hilton university place hotel	HUM
why food products or food contaminated wastes cannot be recycled?	DESC
who owns cnn cable news network	HUM
is the sec constitutional	DESC
how long can i keep cooked italian sausage in refrigerator	NUM
was the great wall of china breached	DESC
how tall is samus aran	NUM
average money market interest rates	NUM
can vcenter standard manage essentials plus	DESC
phone number for bc transit junction	NUM
_______ sediments originate from elements in seawater that precipitate out of solution.	ENTY
carnationï¿½ evaporated milk total calories	NUM
highest mileage crossover india	NUM
how long does it take to process your request for ssa retirement benefits?	NUM
what's the difference between jambalaya and paella	DESC
average temp in fort worth in march	NUM
who is the boss of google?	HUM
is cortana smart???	DESC
is education a constitutional right	DESC
who is the grinning man	HUM
rigorous testing definition	DESC
architectural design	DESC
average amount of money stna make	NUM
carbon reactivation facilities california	ENTY
hydrocodone price per pill	NUM
____________________ is considered the father of modern medicine.	HUM
is the hawb the tracking number	DESC
is callahan an irish name	DESC
who was the basket of apples by	HUM
is thread.sleep implicit wait	DESC
statute of limitations definition	DESC
who paul clark	HUM
blue sky charge controller price	NUM
does singing burn calories	DESC
is it normal to have heartburn during the first trimester pregnancy	DESC
temperature diode	NUM
neonatal hemochromatosis causes	DESC
has a mlb team ever gone undefeated in the regular season	DESC
weather in fletcher,nc	DESC
circulation money definition	DESC
definition of purse	DESC
difference between watt and hertz	DESC
how could the courts check the bureaucracy	DESC
definition, nepotism	DESC
how big do newfypoo's get	NUM
linking verb synonym	DESC
what's the temperature in tucson arizona right now?	NUM
who played fiddle for boxcar willie	HUM
effects hot stone has on the circulatory system	DESC
molar mass of phenol	NUM